type octile
height 32
width 20
map
TTTTTTTTTTTTTTTTTTTT
T..................T
T................A.T
T..................T
T..................T
T..................T
T..................T
T..................T
T..................T
T..................T
T..................T
T..................T
T..................T
T..................T
T..................T
T..................T
T..................T
T..................T
T..................T
T..................T
T..................T
T..................T
T..................T
T..................T
T..................T
T..................T
T..................T
T..................T
T..................T
T.X................T
T..................T
TTTTTTTTTTTTTTTTTTTT
