type octile
height 34
width 29
map
TTTTTTTTTTTTTTTTTTTTTTTTTTTTT
TTTTTTTTTTTTTTTTTTTTTTTTTTTTT
TTTTTTTTTTTTTTTTTTTTTTTTTTTTT
TTT.......................TTT
TTT.......................TTT
TTT............A..........TTT
TTT.......................TTT
TTT.......................TTT
TTT.......................TTT
TTT.......................TTT
TTTTTTTTTTTTTTTTTTTTTT....TTT
TTTTTTTTTTTTTTTTTTTTTT....TTT
TTTTTTTTTTTTTTTTTTTTTT....TTT
TTT.......................TTT
TTT.......................TTT
TTT.......................TTT
TTT.......................TTT
TTT.......................TTT
TTT.......................TTT
TTT.......................TTT
TTT.......................TTT
TTT.......................TTT
TTT.......................TTT
TTT....TTTTTTTTTTTTTTTTTTTTTT
TTT....TTTTTTTTTTTTTTTTTTTTTT
TTT....TTTTTTTTTTTTTTTTTTTTTT
TTT.......................TTT
TTT.......................TTT
TTT.......................TTT
TTT.X.....................TTT
TTT.......................TTT
TTTTTTTTTTTTTTTTTTTTTTTTTTTTT
