type octile
height 28
width 32
map
TTTTTTTTTTTTTTTTTTTTTTTTTTTTTTTT
T...............................
T..............X................
T...............................
T...............................
T............TTTT...............
T............T..T...............
T............T..T...............
T............T..T...............
T............T..T...............
T............T..T...............
T......TTT...T..T.....TTT.......
T......T.....T..T.......T.......
T......T.....T..T.......T.......
T......T.....T..T.......T.......
T......T.....T..T.......T.......
T......TTT...T..T.....TTT.......
T............T..T...............
T............T..T...............
T............T..T...............
T............T..T...............
T............T..................
T...............................
T..............A................
T...............................
T...............................
T...............................
T...............................
