type octile
height 28
width 32
map
TTTTTTTTTTTTTTTTTTTTTTTTTTTTTTTT
T...............................
T..............X................
T...............................
T...............................
T............TTTTTT.............
T............T....T.............
T............T....T.............
T...............................
T...............................
T...............................
T......TTT............TTT.......
T......T................T.......
T......T........A.......T.......
T......T................T.......
T......T................T.......
T......TTT............TTT.......
T...............................
T...............................
T...............................
T............T....T.............
T............T....T.............
T............TTTTTT.............
T...............................
T...............................
T...............................
T...............................
T...............................
