type octile
height 28
width 32
map
TTTTTTTTTTTTTTTTTTTTTTTTTTTTTTTT
T.............X................T
T..............................T
T..............................T
T..............................T
T..............................T
T..............................T
T..............................T
T..............................T
T..............................T
T..............................T
T..............................T
T..............................T
T...............A..............T
T..............................T
T..............................T
T..............................T
T..............................T
T..............................T
T..............................T
T..............................T
T..............................T
T..............................T
T..............................T
T..............................T
T..............................T
T..............................T
TTTTTTTTTTTTTTTTTTTTTTTTTTTTTTTT
