type octile
height 50
width 50
map
TTTTTTTTTTTTTTTTTTTTTTTTTTTTTTTTTTTTTTTTTTTTTTTTTT
T...............................................TT
T........................................X......TT
T...............................................TT
T...............................................TT
TTTTTTTTTTTTTTTTTTTTTTTTTTTT....................TT
T...............................................TT
T...............................................TT
T...............................................TT
T...............................................TT
T..........TTTTTTTTTTTTTTTTTTTTTTTTTTTTTTTTTTTTTTT
T..........T....................................TT
T..........T....................................TT
T..........T....................................TT
T..........T...............T....................TT
T..........T...............T....................TT
T..........T...............T....................TT
T..........................TTTTTTTTTTTTTTTTTTTTTTT
T...............................................TT
T...............................................TT
T...............................................TT
T...............................................TT
TTTTTTTTTTTTTTTTTTTTTTTTTTTTT...................TT
T...........................TTTTT...............TT
T...............................................TT
T...............................................TT
T...............................................TT
T...................T...........................TT
T...................T...........................TT
T...................TTTTTTTTTTTTTTTTTTTTTTTTTTTTTT
T...............................................TT
T...............................................TT
T...............................................TT
T...............................................TT
T..................TTTTTTTTTTTT.................TT
T..................T..........T.................TT
T.............................T.................TT
T.............................T.................TT
T.............................T.................TT
TTTTTTTTTTTTTTTTTTTTTTTTTTTTTTT.................TT
T..................T..........T.................TT
T..................T..........T.................TT
T..................T..........T.................TT
T....A.............T..........T.................TT
T...............................................TT
T...............................................TT
T...............................................TT
T...............................................TT
TTTTTTTTTTTTTTTTTTTTTTTTTTTTTTTTTTTTTTTTTTTTTTTTTT
TTTTTTTTTTTTTTTTTTTTTTTTTTTTTTTTTTTTTTTTTTTTTTTTTT
